40 30 overworld map1 1 3
19 19 19 19 19 19 19 19 19 41 42 43 42 63 19 19 19 19 19 19 19 19 19 19 19 19 19 19 19 19 19 19 19 19 19 19 19 19 19 19
19 19 19 19 19 19 19 19 19 41 42 43 42 63 19 19 19 19 19 19 19 19 19 19 19 19 19 19 19 19 19 19 19 19 19 19 19 19 19 19
19 19 19 19 19 19 19 19 19 41 42 43 42 63 19 19 19 19 19 19 19 19 19 19 26 29 29 29 27 19 19 19 19 19 19 19 19 19 19 19
19 19 19 19 19 19 19 19 19 41 42 43 42 63 19 19 19 26 29 29 29 29 29 29 30 1 1 1 28 29 29 29 27 19 19 19 19 19 19 19
19 19 19 19 19 19 19 19 26 51 52 53 61 62 29 29 29 30 1 1 1 1 11 1 1 11 11 1 1 1 1 1 28 29 27 19 19 19 19 19
19 19 19 19 19 19 19 26 30 1 13 14 15 1 1 1 1 1 1 1 11 11 11 11 11 11 69 70 1 1 1 11 1 1 28 27 19 19 19 19
19 19 19 19 19 19 26 30 1 1 13 14 15 1 1 11 11 11 11 11 11 1 1 11 11 1 89 90 1 1 1 11 11 1 1 28 27 19 19 19
19 19 19 19 19 26 30 1 1 1 13 14 16 5 11 1 1 69 70 1 1 11 11 1 11 11 99 100 1 1 1 1 11 11 1 1 18 19 19 19
19 19 19 19 19 20 1 1 1 11 13 14 14 15 11 1 11 89 90 1 11 11 11 1 1 1 1 1 11 11 11 1 1 1 1 1 28 27 19 19
19 19 19 19 26 30 1 1 1 1 23 7 14 16 5 11 11 99 100 1 11 1 11 1 1 1 1 11 11 11 11 1 1 1 1 1 1 18 19 19
19 19 19 26 30 1 1 1 1 1 1 13 14 14 15 11 11 11 11 11 1 1 1 11 1 1 1 1 1 1 11 11 1 11 11 11 1 18 19 19
19 19 19 20 1 1 1 69 70 11 1 23 7 14 15 11 11 11 11 1 1 1 1 1 11 1 1 1 1 1 1 11 11 69 70 11 1 18 19 19
19 19 19 20 1 1 1 89 90 11 11 11 13 14 15 1 11 11 11 11 1 11 11 1 11 11 1 1 1 1 11 11 1 89 90 11 1 18 19 19
19 19 26 30 1 1 1 99 100 11 1 1 13 14 15 1 1 11 1 11 11 11 11 11 11 11 1 1 1 1 11 11 1 99 100 1 8 37 19 19
19 19 20 1 1 1 11 11 11 1 11 11 13 14 16 5 11 11 11 11 1 11 11 11 11 11 1 1 1 11 11 1 1 11 11 1 18 19 19 19
19 19 20 1 11 11 11 11 1 1 11 11 13 14 14 15 11 11 11 1 11 1 11 1 11 1 1 38 34 35 38 38 38 38 1 1 18 19 19 19
19 19 20 1 1 11 11 1 11 11 1 11 23 7 14 16 5 1 11 1 11 11 1 11 1 69 70 39 44 54 39 39 39 39 1 1 18 19 19 19
19 19 20 1 1 11 11 1 1 11 11 1 1 13 14 14 16 5 11 11 11 1 11 1 1 89 90 40 40 40 40 40 40 40 1 8 37 19 19 19
19 19 20 1 1 1 11 11 11 11 11 1 11 23 7 14 14 16 5 1 11 11 1 11 11 99 100 45 46 46 47 48 49 50 1 18 19 19 19 19
19 19 20 1 1 1 1 11 1 11 11 11 11 1 23 7 14 14 16 4 5 11 11 11 11 11 1 55 56 56 57 58 59 60 1 18 19 19 19 19
19 19 20 1 1 69 70 1 11 1 11 11 11 1 1 23 7 14 14 14 16 4 4 5 1 1 11 11 3 17 14 14 15 1 1 18 19 19 19 19
19 19 20 1 11 89 90 1 1 11 11 11 11 1 1 11 23 24 7 14 14 14 14 16 4 4 4 4 17 14 14 14 15 1 1 18 19 19 19 19
19 19 20 1 11 99 100 1 1 11 11 11 11 11 11 11 11 11 23 24 24 7 14 14 14 14 14 14 14 14 6 24 25 1 1 18 19 19 19 19
19 19 20 1 11 1 11 11 1 11 11 11 69 70 11 11 11 11 11 11 11 23 24 24 24 24 24 24 24 24 25 1 1 1 8 37 19 19 19 19
19 19 36 10 1 11 1 11 11 1 1 1 89 90 11 11 11 11 11 11 69 70 1 1 1 1 1 1 1 1 1 8 9 9 37 19 19 19 19 19
19 19 19 36 10 11 1 1 1 11 11 11 99 100 11 11 1 1 1 1 89 90 1 1 1 1 1 1 8 9 9 37 19 19 19 19 19 19 19 19
19 19 19 19 36 9 9 10 1 1 1 1 1 1 1 1 1 1 1 1 99 100 1 8 9 9 9 9 37 19 19 19 19 19 19 19 19 19 19 19
19 19 19 19 19 19 19 36 9 9 9 9 9 9 9 9 9 9 9 9 9 9 9 37 19 19 19 19 19 19 19 19 19 19 19 19 19 19 19 19
19 19 19 19 19 19 19 19 19 19 19 19 19 19 19 19 19 19 19 19 19 19 19 19 19 19 19 19 19 19 19 19 19 19 19 19 19 19 19 19
19 19 19 19 19 19 19 19 19 19 19 19 19 19 19 19 19 19 19 19 19 19 19 19 19 19 19 19 19 19 19 19 19 19 19 19 19 19 19 19
1 0 0 map2
2 13 6 1
2 22 6 1
2 32 6 1
2 8 9 1
2 24 12 1
2 17 13 1
2 31 13 1
2 4 16 1
2 9 19 1
2 16 23 1
2 22 26 1