12 10
18 18 18 18 18 18 18 18 18 18 18 18
18 18 18 18 18 18 18 18 18 18 18 18
18 18 18 18 18 18 18 18 18 18 18 18
18 18 18 18 18 18 18 18 18 18 18 18
18 18 18 18 18 18 18 18 18 18 18 18
18 18 18 18 18 18 18 18 18 18 18 18
18 18 18 18 18 18 18 18 18 18 18 18
18 18 18 18 18 18 18 18 18 28 28 28
18 18 28 18 18 18 18 18 28 28 28 28
0 28 28 28 28 28 28 28 28 28 28 28

