40 50 overworld map2 19 21
19 19 19 19 19 19 19 19 19 19 19 19 19 19 19 19 19 19 19 19 19 19 19 19 19 19 19 19 19 19 19 19 19 19 19 19 19 19 19 19
19 19 19 19 19 19 19 19 19 19 19 19 19 19 19 19 19 19 19 19 19 19 19 19 19 19 19 19 19 19 19 19 19 19 19 19 19 19 19 19
19 19 19 19 19 19 19 19 19 19 19 19 19 19 19 19 19 19 19 19 19 19 19 19 19 19 19 19 19 19 19 19 19 19 19 19 19 19 19 19
19 19 19 19 19 19 19 19 19 19 19 19 19 19 19 19 19 19 19 19 19 19 19 19 19 19 19 19 19 19 19 19 19 19 19 19 19 19 19 19
19 19 19 19 19 19 19 19 19 19 19 19 19 19 19 19 19 19 19 19 19 19 19 19 19 19 19 19 19 19 19 19 19 19 19 19 19 19 19 19
19 19 19 19 19 19 19 19 19 19 19 19 19 19 19 19 19 19 19 19 19 19 26 29 29 29 29 29 27 19 19 19 19 19 19 19 19 19 19 19
19 19 19 19 19 19 19 19 19 19 19 19 19 19 19 26 29 29 29 29 29 29 30 11 1 69 70 1 28 29 29 29 27 19 19 19 19 19 19 19
19 19 19 19 19 19 19 19 19 19 19 19 19 19 26 30 1 11 69 70 1 11 1 1 1 89 90 11 1 11 1 1 28 27 19 19 19 19 19 19
19 19 19 19 19 19 19 19 19 19 19 26 29 29 30 1 1 11 89 90 1 1 1 1 1 99 100 69 70 11 1 69 70 18 19 19 19 19 19 19
19 19 19 19 19 19 19 19 19 19 26 30 1 11 11 11 1 1 99 100 11 11 11 11 1 1 11 89 90 1 11 79 80 18 19 19 19 19 19 19
19 19 19 19 19 19 19 19 19 26 30 11 11 11 11 1 1 1 1 1 1 1 1 1 1 1 1 99 100 11 1 79 80 18 19 19 19 19 19 19
19 19 19 19 19 19 19 19 26 30 1 11 1 1 1 1 11 11 3 4 4 4 4 4 4 4 4 5 1 1 11 79 80 18 19 19 19 19 19 19
19 19 19 19 19 19 19 26 30 1 11 1 1 1 1 1 3 4 17 14 14 14 14 14 14 14 14 16 5 1 1 79 80 18 19 19 19 19 19 19
19 19 19 19 19 19 26 30 1 1 69 70 1 1 11 3 17 14 14 14 14 14 6 7 14 14 14 14 16 4 5 89 90 18 19 19 19 19 19 19
19 19 19 19 19 19 20 1 1 11 89 90 11 11 3 17 14 14 14 6 24 24 25 23 24 24 7 14 14 14 15 99 100 28 27 19 19 19 19 19
19 19 19 19 19 26 30 1 11 1 99 100 1 3 17 14 14 6 24 25 1 1 11 11 1 1 23 7 14 14 15 1 1 1 18 19 19 19 19 19
19 19 19 19 19 20 1 11 11 1 1 1 3 17 14 14 6 25 1 1 1 11 1 11 11 1 1 13 14 14 15 1 1 1 18 19 19 19 19 19
19 19 19 19 19 20 1 1 1 1 11 1 13 14 14 6 25 1 1 11 8 9 9 10 1 1 1 13 14 14 15 1 1 11 18 19 19 19 19 19
19 19 19 19 19 20 1 1 1 11 1 1 13 14 14 15 1 1 1 8 37 19 19 20 69 70 1 13 14 14 15 1 11 11 18 19 19 19 19 19
19 19 19 19 19 20 1 11 11 1 1 1 13 14 14 15 1 11 1 18 19 19 19 20 89 90 1 13 14 14 15 1 11 1 18 19 19 19 19 19
19 19 19 19 19 20 1 11 1 1 1 3 17 14 6 25 1 1 1 18 19 19 19 20 99 100 1 13 14 14 15 1 1 8 37 19 19 19 19 19
19 19 19 19 19 20 11 11 1 69 70 13 14 14 15 1 1 1 1 18 19 19 19 36 10 1 1 13 14 14 15 11 1 18 19 19 19 19 19 19
19 19 19 19 19 20 11 1 1 89 90 13 14 14 15 1 1 1 1 18 19 19 19 19 20 11 1 13 14 14 15 1 1 18 19 19 19 19 19 19
19 19 19 19 19 20 11 1 1 99 100 13 14 14 15 1 11 11 8 37 19 19 19 19 20 11 1 13 14 14 15 11 11 18 19 19 19 19 19 19
19 19 19 19 19 20 11 1 1 11 11 13 14 14 15 1 11 1 18 19 19 19 19 19 20 11 1 13 14 14 15 11 1 18 19 19 19 19 19 19
19 19 19 19 19 20 1 1 11 11 1 13 14 6 25 1 11 1 18 19 19 19 19 19 20 11 1 13 14 14 15 11 1 18 19 19 19 19 19 19
19 19 19 19 19 20 1 1 11 1 1 13 14 15 1 1 11 1 18 19 19 19 19 19 20 1 1 13 14 14 15 11 11 18 19 19 19 19 19 19
19 19 19 19 19 20 11 11 11 1 1 13 14 15 1 1 1 8 37 19 19 19 19 19 20 1 1 13 14 14 15 11 11 18 19 19 19 19 19 19
19 19 19 19 19 20 1 11 1 1 3 17 14 15 1 11 1 18 19 19 19 19 19 19 20 11 1 13 14 14 15 11 1 18 19 19 19 19 19 19
19 19 19 19 19 20 1 11 1 1 13 14 14 15 1 69 70 18 19 19 19 19 19 19 20 11 1 13 14 14 15 11 1 18 19 19 19 19 19 19
19 19 19 19 19 20 1 1 1 1 13 14 14 15 1 89 90 18 19 19 19 19 19 19 20 11 11 23 7 14 15 1 1 18 19 19 19 19 19 19
19 19 19 19 19 36 10 1 1 1 13 14 14 15 1 99 100 18 19 19 19 19 19 19 20 1 11 1 13 14 15 1 11 28 27 19 19 19 19 19
19 19 19 19 19 19 20 1 11 1 13 14 14 15 1 11 1 18 19 19 19 19 19 19 20 1 11 1 13 14 16 5 1 1 28 27 19 19 19 19
19 19 19 19 19 19 20 1 1 1 13 14 6 25 1 11 1 18 19 19 19 19 19 19 20 1 1 1 13 14 14 15 1 11 1 28 27 19 19 19
19 19 19 19 19 19 20 11 11 1 13 14 15 1 11 11 1 18 19 19 19 19 19 19 20 1 1 1 23 7 14 16 5 1 11 11 28 27 19 19
19 19 19 19 19 19 20 1 1 1 13 14 15 1 11 11 11 18 19 19 19 19 19 19 20 11 1 11 1 13 14 14 16 5 1 11 11 28 29 29
19 19 19 19 19 19 20 69 70 1 13 14 15 1 11 11 1 18 19 19 19 19 19 19 20 1 11 11 1 13 14 14 14 16 4 5 1 11 11 1
19 19 19 19 19 19 20 89 90 1 13 14 15 1 11 1 1 18 19 19 19 19 19 19 20 1 11 11 1 23 7 14 14 14 14 16 4 4 4 4
19 19 19 19 19 19 20 99 100 11 13 14 15 1 69 70 1 18 19 19 19 19 19 19 36 10 1 1 1 1 23 24 7 14 14 14 14 14 14 14
19 19 19 19 19 19 20 1 1 11 13 14 15 1 89 90 8 37 19 19 19 19 19 19 19 20 1 11 1 11 1 1 23 24 24 7 14 14 14 14
19 19 19 19 19 19 36 10 1 1 13 14 15 1 99 100 18 19 19 19 19 19 19 19 19 36 10 11 11 11 11 1 1 1 1 23 24 7 14 14
19 19 19 19 19 19 19 36 10 1 13 14 15 1 8 9 37 19 19 19 19 19 19 19 19 19 36 10 11 11 11 11 1 69 70 1 1 23 24 24
19 19 19 19 19 19 19 19 36 31 32 33 21 22 37 19 19 19 19 19 19 19 19 19 19 19 19 36 10 1 1 11 1 89 90 11 1 1 1 1
19 19 19 19 19 19 19 19 19 41 42 43 42 63 19 19 19 19 19 19 19 19 19 19 19 19 19 19 36 10 1 1 1 99 100 11 11 1 1 1
19 19 19 19 19 19 19 19 19 41 42 43 42 63 19 19 19 19 19 19 19 19 19 19 19 19 19 19 19 36 9 10 1 1 1 1 1 8 9 9
19 19 19 19 19 19 19 19 19 41 42 43 42 63 19 19 19 19 19 19 19 19 19 19 19 19 19 19 19 19 19 36 9 9 9 9 9 37 19 19
19 19 19 19 19 19 19 19 19 41 42 43 42 63 19 19 19 19 19 19 19 19 19 19 19 19 19 19 19 19 19 19 19 19 19 19 19 19 19 19
19 19 19 19 19 19 19 19 19 41 42 43 42 63 19 19 19 19 19 19 19 19 19 19 19 19 19 19 19 19 19 19 19 19 19 19 19 19 19 19
19 19 19 19 19 19 19 19 19 41 42 43 42 63 19 19 19 19 19 19 19 19 19 19 19 19 19 19 19 19 19 19 19 19 19 19 19 19 19 19
19 19 19 19 19 19 19 19 19 41 42 43 42 63 19 19 19 19 19 19 19 19 19 19 19 19 19 19 19 19 19 19 19 19 19 19 19 19 19 19
1 1 0 map1
1 3 0 map3
2 14 10 2
2 27 12 1
2 32 18 1
2 16 22 1
2 28 24 2
2 8 27 1
2 31 31 2
2 15 35 1
2 35 35 2
2 28 37 1
2 36 39 2
2 37 42 2