10 7 overworld 5 10
11 11 11 11 11 11 11 11 11 11
11 0 0 0 0 0 0 0 0 11
11 0 0 0 0 0 0 0 0 11
0 0 0 0 0 0 0 0 0 0
11 0 0 0 0 0 0 0 0 11
11 0 0 0 0 0 0 0 0 11
11 11 11 11 11 11 11 11 11 11
1 9 3 map1 34 24