10 10 overworld 2 2
12 12 12 12 12 12 12 12 12 12
12 3 4 4 5 1 1 1 1 12
12 13 14 14 15 1 1 1 1 12
12 13 14 14 15 1 1 1 1 12
12 23 24 24 25 1 1 1 1 12
12 1 1 1 1 1 1 1 1 12
12 1 1 1 1 1 1 1 1 12
12 1 1 1 1 1 1 1 1 12
12 1 1 1 1 1 1 1 1 12
12 12 12 12 12 12 12 12 12 12