100 100 overworld map3 21 21
19 19 19 19 19 19 19 19 19 19 19 19 19 19 19 19 19 19 19 19 19 19 19 19 19 19 19 19 19 19 19 19 19 19 19 19 19 19 19 19 19 19 19 19 19 19 19 19 19 19 19 19 19 19 19 19 19 19 19 19 19 19 19 19 19 19 19 19 19 19 19 19 19 19 19 19 19 19 19 19 19 19 19 19 19 19 19 19 19 19 19 19 19 19 19 19 19 19 19 19
19 19 19 19 19 19 19 19 19 19 19 19 19 19 19 19 19 19 19 19 19 19 19 19 19 19 19 19 19 19 19 19 19 19 19 19 19 19 19 19 19 19 19 19 19 19 19 19 19 19 19 19 19 19 19 19 19 19 19 19 19 19 19 19 19 19 19 19 19 19 19 19 19 19 19 19 19 19 19 19 19 19 19 19 19 19 19 19 19 19 19 19 19 19 19 19 19 19 19 19
19 19 19 19 19 19 19 19 19 19 19 19 19 19 19 19 19 19 19 19 19 19 19 19 19 19 19 19 19 19 19 19 19 19 19 19 19 19 19 19 19 19 19 19 19 19 19 19 19 19 19 19 19 19 19 19 19 19 19 19 19 19 19 19 19 19 19 19 19 19 19 19 19 19 19 19 19 19 19 19 19 19 19 19 19 19 19 19 19 19 19 19 19 19 19 19 19 19 19 19
19 19 19 19 19 19 19 19 19 19 19 19 19 19 19 19 19 19 19 19 19 19 19 19 19 19 19 19 19 19 19 19 19 19 19 19 19 19 19 19 19 19 19 19 19 19 19 19 19 19 19 19 19 19 19 19 19 19 19 19 19 19 19 19 19 19 19 19 19 19 19 19 19 19 19 19 19 19 19 19 19 19 19 19 19 19 19 19 19 19 19 26 29 29 29 27 19 19 19 19
19 19 19 19 19 19 19 19 19 19 19 19 19 26 29 29 29 29 29 29 29 29 29 29 29 27 19 19 19 19 19 19 19 19 19 19 19 19 19 19 19 19 19 19 19 19 19 19 19 19 19 19 19 19 19 19 19 19 19 19 19 19 19 19 19 19 19 19 19 19 19 19 19 19 19 19 19 19 19 19 19 19 19 19 19 19 19 19 19 19 26 30 1 1 8 37 19 19 19 19
19 19 19 19 19 19 19 19 19 19 19 19 19 20 1 1 1 1 1 1 1 1 1 1 1 28 27 19 19 19 19 19 19 19 19 19 19 19 19 19 19 19 19 19 19 19 19 19 19 19 19 19 19 19 19 19 19 19 19 26 29 29 27 19 19 19 19 19 19 19 19 19 19 19 19 19 19 19 19 19 19 19 19 19 19 19 19 19 19 26 30 1 1 1 18 19 19 19 19 19
19 19 19 19 19 19 19 19 19 26 29 29 29 30 1 1 1 1 1 1 1 1 1 1 1 1 28 29 29 29 29 27 19 19 19 19 19 19 19 19 19 19 19 19 19 19 19 19 19 19 19 19 19 19 26 29 29 29 29 30 1 1 28 29 29 27 19 19 19 19 19 19 19 19 19 19 19 19 19 19 19 19 19 19 19 19 19 26 29 30 1 1 1 1 18 19 19 19 19 19
19 19 19 19 19 26 29 29 29 30 1 1 1 1 1 1 1 1 1 3 4 4 4 4 4 4 4 4 5 1 1 28 29 29 29 29 29 29 29 29 29 29 29 29 29 29 29 29 29 29 29 29 29 29 30 1 1 1 1 1 1 1 1 1 1 28 29 29 29 29 29 29 29 29 29 29 27 19 19 19 19 19 19 19 26 29 29 30 1 1 1 1 1 1 18 19 19 19 19 19
19 19 19 26 29 30 1 1 1 1 1 1 1 1 1 1 1 1 1 13 14 6 24 24 24 7 14 14 16 5 1 1 3 4 4 4 4 4 4 4 4 4 5 1 1 11 11 11 11 11 1 1 1 1 1 1 1 1 1 1 1 1 1 1 1 1 1 1 1 1 1 1 1 1 1 1 28 29 29 29 29 29 29 29 30 1 1 1 1 69 70 69 70 1 18 19 19 19 19 19
19 19 19 20 1 1 1 1 1 1 1 1 1 1 1 1 1 1 3 17 14 15 1 1 1 23 24 7 14 15 3 4 17 6 24 24 24 24 24 24 7 14 16 4 5 1 11 11 11 11 11 11 11 1 1 1 1 1 1 11 11 11 11 11 11 1 1 1 1 1 1 1 1 1 1 1 1 1 1 1 1 1 1 1 1 1 1 69 70 79 80 79 80 1 18 19 19 19 19 19
19 19 19 20 1 1 1 1 1 1 1 1 1 1 1 1 1 1 13 14 6 25 1 1 1 1 1 23 7 16 17 14 6 25 11 1 1 1 1 1 23 7 14 14 16 5 1 1 1 1 1 1 11 11 1 1 1 1 1 1 1 1 1 1 11 11 11 1 1 1 1 1 1 1 1 1 1 1 1 1 1 1 1 1 1 69 70 79 80 89 90 89 90 1 28 27 19 19 19 19
19 19 19 20 1 1 1 1 1 1 11 1 1 1 1 1 1 1 13 14 15 1 8 9 10 1 1 1 23 24 24 24 25 1 1 1 1 1 1 1 1 23 24 7 14 15 1 1 1 1 1 11 11 11 1 1 1 1 1 1 1 1 1 1 1 1 1 1 1 1 1 1 1 1 1 1 1 1 1 1 1 1 1 1 1 79 80 89 90 99 100 99 100 69 70 18 19 19 19 19
19 19 19 20 1 1 1 1 1 11 11 1 1 1 1 1 1 1 13 14 15 1 18 19 36 10 8 9 9 9 9 9 9 9 10 1 1 1 11 11 1 1 1 13 14 16 4 4 4 5 1 1 1 1 1 3 4 4 4 5 1 3 4 4 5 1 1 1 1 1 1 1 1 1 1 1 1 1 1 1 1 1 1 69 70 89 90 99 100 69 70 69 70 79 80 18 19 19 19 19
19 19 19 20 1 1 1 1 1 11 1 1 1 1 1 1 1 1 13 14 15 1 18 19 19 20 18 19 19 19 19 19 19 19 20 1 1 1 1 11 11 1 1 23 24 24 24 7 14 16 4 4 4 4 4 17 14 14 14 16 4 17 14 14 16 4 4 4 5 1 1 1 1 1 1 1 1 1 1 1 11 11 11 79 80 99 100 69 70 79 80 79 80 89 90 18 19 19 19 19
19 19 19 20 1 1 1 1 11 11 1 1 1 1 11 1 1 1 13 14 15 1 28 29 29 30 28 29 29 29 29 29 29 29 30 1 1 1 1 1 11 11 1 1 1 1 1 23 7 14 14 14 14 14 14 14 6 7 14 14 14 14 14 14 14 14 14 14 16 4 4 4 5 1 1 1 1 1 1 1 1 1 1 89 90 69 70 79 80 89 90 89 90 99 100 18 19 19 19 19
19 19 19 20 1 1 1 1 11 1 11 1 1 1 11 1 1 1 13 14 15 1 8 9 9 10 8 9 9 9 9 9 9 9 9 9 10 1 1 1 1 1 11 11 1 1 1 1 23 24 24 24 24 24 24 24 25 23 24 24 24 24 24 7 14 6 24 7 14 14 14 14 15 1 1 1 1 1 1 1 1 1 1 99 100 79 80 89 90 99 100 99 100 1 1 18 19 19 19 19
19 19 19 20 1 1 1 1 11 1 11 1 1 1 11 1 1 1 13 14 15 1 18 19 19 20 18 19 19 19 19 19 19 19 19 19 20 1 1 1 1 1 1 11 11 1 1 1 1 1 1 1 1 1 1 1 1 1 1 1 1 1 1 23 24 25 1 23 24 24 7 14 15 1 1 1 1 1 1 1 1 1 1 11 11 89 90 99 100 11 1 1 1 1 1 18 19 19 19 19
19 19 19 20 1 1 1 11 1 1 11 1 1 1 11 11 1 1 13 14 15 1 28 29 29 30 28 29 29 29 29 29 29 29 29 29 30 1 1 1 1 1 1 3 4 5 1 1 1 1 1 1 1 1 1 1 1 1 1 1 1 1 1 1 1 1 1 1 1 1 13 14 15 1 1 1 1 1 1 1 1 1 1 11 1 99 100 1 1 11 11 1 1 1 1 18 19 19 19 19
19 19 19 20 1 1 1 11 1 1 11 1 1 1 1 1 11 1 13 14 15 1 1 1 1 1 11 1 1 1 1 1 1 1 1 1 1 1 1 1 1 1 1 13 14 15 1 1 1 1 1 1 1 1 1 1 1 1 1 1 1 1 1 1 1 1 1 1 1 1 13 14 15 1 1 1 1 1 1 1 1 1 1 1 1 1 1 1 1 1 1 1 1 1 1 18 19 19 19 19
19 19 19 20 1 1 1 11 1 11 1 1 1 1 1 1 1 11 23 7 16 4 5 1 1 1 1 11 11 11 11 11 1 1 1 1 1 1 1 1 1 1 1 23 24 25 1 1 1 1 1 1 1 1 1 1 1 1 1 1 1 1 1 1 1 1 1 1 1 3 17 14 15 1 1 11 11 1 1 1 1 1 1 1 1 1 11 1 1 1 1 1 11 1 1 18 19 19 19 19
19 19 19 20 1 1 1 1 1 11 1 1 1 1 1 1 1 11 11 23 24 7 16 4 4 4 4 4 5 1 1 1 1 11 1 11 11 11 11 11 1 11 1 1 1 11 1 1 1 1 11 1 1 1 11 1 1 1 11 1 11 11 11 11 1 1 1 1 1 13 14 14 15 1 1 1 1 11 11 1 1 1 1 1 1 1 11 11 1 1 11 11 11 1 1 18 19 19 19 19
19 19 19 20 1 1 1 1 69 70 1 1 1 69 70 1 1 1 11 11 1 23 24 24 24 24 7 14 15 1 1 1 1 11 1 11 1 1 1 11 1 11 1 1 1 11 1 1 1 11 11 1 1 11 11 1 1 11 11 1 1 1 1 11 1 1 1 1 1 13 14 6 25 1 1 1 1 1 11 11 1 1 1 1 1 1 1 11 11 11 11 1 1 1 1 18 19 19 19 19
19 19 19 20 1 1 1 1 89 90 1 1 1 89 90 1 1 1 1 1 1 1 1 1 1 3 17 14 15 1 1 1 1 11 1 11 1 1 1 11 1 1 11 1 11 1 1 1 11 1 11 1 11 1 11 1 11 1 11 1 1 1 1 11 1 1 1 1 1 13 14 15 1 1 1 1 1 1 1 1 11 11 11 1 1 1 1 1 1 1 1 1 1 1 1 18 19 19 19 19
19 19 19 20 1 1 11 11 99 100 1 1 1 99 100 1 1 1 1 1 1 1 1 1 1 13 14 14 15 1 1 1 1 11 1 11 11 11 11 11 1 1 11 1 11 1 1 1 1 1 11 1 1 1 11 1 1 1 11 1 1 11 11 11 1 1 1 1 1 13 14 16 5 1 1 1 1 1 1 1 1 1 1 1 1 1 1 1 1 1 1 1 1 1 8 37 19 19 19 19
19 19 26 30 1 1 1 1 11 11 11 11 11 1 1 1 1 1 1 1 1 1 1 1 1 13 14 6 25 1 1 1 1 11 1 11 1 1 1 11 1 1 11 1 11 1 1 1 1 1 11 1 1 1 11 1 1 1 11 1 1 1 1 11 1 1 1 1 1 13 14 14 15 1 3 4 4 4 5 1 3 4 4 4 4 4 4 5 1 1 1 1 1 1 18 19 19 19 19 19
19 19 20 1 1 1 1 1 1 1 11 1 1 69 70 11 1 1 1 1 1 1 1 1 3 17 14 15 1 1 1 1 1 11 1 11 1 1 1 11 1 1 11 11 11 1 1 1 1 1 11 1 1 1 11 1 1 1 11 1 1 1 1 11 1 1 1 1 1 23 7 14 16 4 17 14 14 14 16 4 17 14 14 14 14 14 14 16 4 5 1 1 1 1 18 19 19 19 19 19
19 19 36 10 1 1 1 1 69 70 11 1 1 89 90 11 1 11 69 70 1 1 1 1 13 14 14 15 1 1 1 1 1 11 1 11 1 1 1 11 1 1 1 11 1 1 1 1 1 1 11 1 1 1 11 1 1 1 11 1 11 11 11 11 1 1 1 1 1 1 13 14 14 14 14 14 6 7 14 14 14 14 6 24 24 24 7 14 14 15 1 1 1 1 18 19 19 19 19 19
19 19 19 20 1 1 1 1 89 90 11 1 1 99 100 11 11 11 89 90 1 1 1 1 13 14 6 25 1 1 1 1 1 1 1 1 1 1 1 1 1 1 1 1 1 1 1 1 1 1 1 1 1 1 1 1 1 1 1 1 1 1 1 1 1 1 1 1 1 1 23 24 24 24 24 24 25 23 24 24 24 24 25 1 1 1 23 7 14 15 1 1 1 8 37 19 19 19 19 19
19 19 19 20 1 1 1 1 99 100 11 1 1 1 1 11 11 11 99 100 1 1 1 1 13 14 15 1 1 1 1 1 1 1 1 1 1 1 1 1 1 1 1 1 1 1 1 1 1 1 1 1 1 1 1 1 1 1 1 1 1 1 1 1 1 1 1 1 1 1 1 1 1 1 1 1 1 1 1 1 1 1 1 1 1 1 1 13 14 15 1 1 1 18 19 19 19 19 19 19
19 19 19 20 1 1 1 1 1 11 11 1 1 1 69 70 1 1 1 1 1 1 1 1 13 14 15 1 1 1 1 1 1 1 1 1 1 1 1 1 1 1 1 1 1 1 1 1 1 1 1 1 1 1 1 1 1 1 1 1 1 1 1 1 1 1 1 1 1 1 1 1 1 1 1 1 1 1 1 1 1 1 1 1 1 1 1 13 14 15 1 1 1 18 19 19 19 19 19 19
19 19 19 20 1 1 1 1 1 1 11 11 1 1 89 90 1 1 1 1 1 1 1 3 17 14 15 1 1 1 1 1 1 1 1 1 3 4 4 4 5 1 1 1 1 1 1 1 1 1 1 1 1 1 11 1 1 1 1 1 1 11 11 1 1 1 1 1 1 1 1 1 1 1 1 1 1 1 1 1 1 1 1 1 1 1 1 13 14 15 1 1 1 18 19 19 19 19 19 19
19 19 19 20 1 1 1 1 1 1 11 11 1 1 99 100 1 1 11 1 1 1 1 13 14 14 15 1 1 1 1 1 3 4 4 4 17 14 14 14 16 5 1 1 1 1 1 1 1 1 1 1 11 11 11 11 1 1 1 1 11 11 11 1 1 1 1 1 1 1 1 1 1 1 1 1 3 4 5 1 11 11 1 1 1 1 1 13 14 15 1 1 1 18 19 19 19 19 19 19
19 19 19 20 1 1 1 1 69 70 11 1 69 70 1 11 1 11 11 1 1 1 1 13 14 6 25 1 1 1 3 4 17 14 14 14 14 14 14 14 14 16 4 5 1 1 1 1 1 1 1 11 11 1 11 11 1 1 1 11 11 1 11 11 1 1 1 1 1 1 1 1 1 1 1 3 17 14 16 5 1 11 1 1 1 1 1 13 14 15 1 1 1 18 19 19 19 19 19 19
19 19 19 20 1 1 1 1 89 90 11 1 89 90 1 69 70 11 1 1 1 1 1 13 14 15 1 1 1 3 17 14 14 6 24 24 24 24 24 24 7 14 14 15 1 1 1 1 1 1 1 11 1 1 1 11 1 1 11 11 11 1 11 11 1 1 1 1 1 1 3 4 4 4 4 17 14 14 14 15 1 11 11 1 1 1 1 13 14 15 1 69 70 18 19 19 19 19 19 19
19 19 19 20 1 1 1 1 99 100 11 11 99 100 11 89 90 1 1 11 1 1 1 13 14 15 1 1 1 23 7 14 6 25 1 1 1 1 1 1 23 7 14 15 1 1 1 1 1 1 1 1 1 1 1 1 1 1 1 1 1 1 1 1 1 1 1 1 1 3 17 14 14 14 14 14 14 14 14 15 1 1 11 1 1 1 3 17 14 15 1 79 80 28 27 19 19 19 19 19
29 29 29 30 1 1 1 1 1 1 1 1 1 11 11 99 100 1 1 11 1 1 1 13 14 15 1 1 1 1 13 14 16 4 5 1 1 1 1 1 1 13 14 15 1 1 1 1 1 1 1 1 1 1 1 1 1 1 1 1 1 1 1 1 1 1 1 1 3 17 14 14 6 24 24 24 7 14 6 25 1 1 1 1 1 1 13 14 14 15 1 89 90 1 28 29 29 29 29 29
1 1 1 1 1 1 1 1 1 1 1 1 1 1 1 1 1 1 1 11 1 1 1 13 6 25 1 1 1 1 23 7 14 14 15 1 1 1 1 1 1 13 14 15 1 1 1 1 1 1 1 1 1 1 1 1 11 1 1 1 1 1 1 1 1 1 1 3 17 14 14 6 25 1 1 3 17 14 15 1 1 1 1 1 1 1 13 14 6 25 1 99 100 1 1 1 1 1 1 1
4 4 4 4 4 5 1 1 1 1 1 1 1 1 1 1 1 1 1 11 1 1 1 13 15 1 1 1 1 1 1 13 14 14 15 1 1 1 1 1 1 13 14 15 1 1 1 1 1 1 1 1 1 1 1 11 11 1 1 1 1 1 1 1 1 1 3 17 14 14 6 25 1 1 1 13 14 6 25 11 11 11 3 4 4 4 17 14 16 4 4 4 4 4 4 4 4 4 4 5
14 14 14 14 14 16 5 1 1 1 1 1 1 1 1 11 11 11 11 11 1 1 1 13 15 1 1 1 1 1 1 23 24 7 16 5 1 1 1 1 1 23 7 16 5 1 1 1 1 1 1 1 1 1 1 11 11 11 1 1 1 1 1 1 1 1 13 14 14 6 25 1 1 1 1 13 14 16 4 4 4 4 17 14 14 14 14 14 14 14 14 14 14 14 14 14 14 14 14 15
14 14 14 14 14 14 16 5 1 1 1 1 1 1 11 11 1 1 1 1 1 1 1 13 15 1 1 69 70 1 1 1 1 13 14 16 5 1 1 1 1 1 13 14 16 5 1 1 1 1 1 11 1 1 1 1 1 1 1 1 1 1 1 1 1 3 17 6 24 25 1 1 1 1 1 23 24 24 7 14 14 14 14 14 14 14 14 14 14 14 14 14 14 14 14 14 14 14 14 16
14 14 14 14 14 14 14 16 5 1 1 1 1 1 1 1 1 1 1 1 1 1 1 13 16 5 1 89 90 69 70 1 1 23 7 14 16 5 1 1 1 1 23 7 14 16 5 1 1 1 1 11 11 11 1 1 1 1 1 1 11 11 1 1 3 17 14 15 1 1 1 1 1 1 1 1 1 1 23 24 24 24 24 24 24 24 24 24 24 7 14 6 24 24 24 24 7 14 14 14
24 24 24 24 24 24 7 14 16 5 1 1 1 1 1 1 1 1 3 4 4 4 4 17 14 16 5 99 100 89 90 1 1 1 23 7 14 15 1 1 1 1 1 23 7 14 15 1 1 1 1 1 1 11 11 11 11 11 11 11 11 1 1 1 13 14 14 15 1 1 11 1 1 1 3 4 5 1 1 1 11 11 11 11 11 1 1 1 3 17 6 25 11 11 1 1 23 24 7 14
1 1 1 1 1 1 13 14 14 15 1 1 1 1 1 1 3 4 17 14 14 14 14 14 14 14 15 1 1 99 100 1 3 4 4 17 14 15 1 1 1 1 1 1 13 14 15 1 1 1 1 1 1 1 1 1 1 1 1 1 1 1 3 4 17 14 6 25 1 1 11 1 1 3 17 14 16 5 11 11 11 11 1 1 1 1 11 11 13 14 15 1 1 1 1 1 1 1 23 24
1 1 1 1 1 1 13 14 14 15 1 1 1 1 1 3 17 14 14 14 6 24 7 14 6 24 25 1 1 1 3 4 17 14 14 14 14 15 1 1 1 1 1 1 13 14 16 5 1 1 1 1 1 1 1 1 1 1 1 1 3 4 17 14 14 6 25 1 1 1 11 1 1 13 14 14 14 15 1 1 11 11 11 11 11 11 11 1 13 6 25 1 1 1 1 1 1 1 1 1
9 9 9 9 10 1 23 7 14 15 1 1 1 1 3 17 14 14 6 24 25 1 13 14 15 1 1 1 1 1 13 14 14 14 6 24 24 25 1 1 1 1 1 1 23 7 14 16 5 1 1 1 1 1 1 1 1 1 1 1 13 14 14 14 6 25 1 1 1 1 11 1 1 13 14 6 7 15 1 11 11 1 1 1 1 1 1 3 17 15 1 1 1 1 1 8 9 9 9 9
19 19 19 19 20 1 1 13 14 16 5 1 1 3 17 14 6 24 25 1 1 1 13 14 15 1 1 1 1 1 13 14 6 24 25 1 1 1 1 1 1 1 1 1 1 23 7 14 16 4 4 5 1 1 1 1 1 1 1 1 13 14 14 6 25 1 1 1 1 1 11 1 3 17 14 15 13 15 11 11 11 11 11 11 11 11 3 17 6 25 1 1 1 1 1 18 19 19 19 19
19 19 19 19 36 10 1 13 14 14 15 1 3 17 14 14 15 1 1 1 1 1 13 14 15 1 1 1 3 4 17 14 15 1 1 1 1 1 1 1 1 1 1 1 1 1 23 24 7 14 14 16 5 1 1 1 1 1 1 1 23 7 14 16 5 1 1 1 1 11 1 1 13 14 14 15 13 15 11 1 1 11 11 11 11 3 17 6 25 1 1 1 1 1 8 37 19 19 19 19
19 19 19 19 19 20 1 23 7 14 15 1 13 14 14 6 25 1 3 4 4 4 17 14 16 4 5 3 17 14 6 24 25 1 1 1 1 69 70 1 1 1 1 1 1 1 1 1 23 24 7 14 15 1 1 1 1 69 70 1 1 13 14 14 15 1 1 1 1 11 1 3 17 14 6 25 13 15 11 11 11 11 11 1 3 17 14 15 1 1 1 1 1 8 37 19 19 19 19 19
19 19 19 19 19 20 1 1 13 14 16 4 17 14 6 25 1 3 17 14 14 14 14 14 14 14 16 17 14 6 25 1 1 1 1 69 70 89 90 69 70 1 1 1 1 1 1 1 1 1 13 14 16 5 1 69 70 89 90 1 1 23 7 14 15 1 1 1 1 1 1 13 14 14 15 11 13 15 11 11 11 11 11 1 13 14 6 25 11 11 1 1 1 18 19 19 19 19 19 19
19 19 19 19 19 20 1 1 13 14 14 14 14 6 25 1 3 17 14 14 6 24 24 24 7 14 14 14 6 25 1 1 1 1 1 89 90 99 100 89 90 1 1 1 1 1 1 1 1 1 13 14 14 15 1 89 90 99 100 1 1 1 13 14 16 4 4 4 5 1 3 17 14 6 25 1 13 16 5 1 1 1 1 3 17 6 25 1 1 1 1 1 8 37 19 19 19 19 19 19
19 19 19 19 19 20 1 1 23 7 14 14 14 15 1 1 13 14 14 6 25 1 1 1 23 24 24 24 25 1 1 1 1 1 1 99 100 1 1 99 100 1 1 1 1 1 1 1 1 1 23 7 14 16 5 99 100 1 1 1 1 1 13 14 14 14 14 14 16 4 17 14 14 15 1 1 13 14 15 1 1 1 3 17 6 25 1 1 1 1 1 1 18 19 19 19 19 19 19 19
19 19 19 19 19 20 1 1 1 23 24 24 24 25 1 1 23 7 14 15 1 1 1 1 1 1 1 1 8 9 9 9 10 1 1 1 1 1 1 1 1 1 1 1 1 1 1 1 1 1 1 13 14 14 16 4 4 4 4 4 4 4 17 14 6 7 14 14 14 14 14 14 6 25 1 1 13 14 16 5 1 3 17 6 25 1 1 1 1 1 1 8 37 19 19 19 19 19 19 19
19 19 19 19 19 20 1 1 1 69 70 1 1 1 1 1 3 17 14 15 1 1 1 1 1 1 1 8 37 19 19 19 20 8 9 9 9 9 9 9 9 9 9 9 9 9 9 9 10 1 1 23 24 7 14 14 14 14 14 14 14 14 14 14 15 23 24 24 24 24 24 24 25 1 1 1 13 14 14 16 4 17 6 25 1 1 1 1 1 1 8 37 19 19 19 19 19 19 19 19
19 19 19 19 19 20 1 1 1 89 90 1 1 1 1 3 17 14 6 25 1 1 1 1 8 9 9 37 19 19 19 19 36 37 19 19 19 19 19 19 19 19 19 19 19 19 19 19 36 10 1 1 1 23 24 24 24 24 24 24 24 24 24 24 25 1 69 70 69 70 1 1 1 1 1 1 23 7 14 14 14 6 25 1 1 1 1 1 1 1 18 19 19 19 19 19 19 19 19 19
19 19 19 19 19 20 1 1 1 99 100 69 70 1 1 13 14 14 15 1 1 1 1 8 37 19 19 19 19 19 19 19 19 19 19 19 19 26 29 27 19 19 19 19 19 19 19 19 19 20 1 1 1 1 1 1 1 1 1 1 1 1 1 1 69 70 89 90 89 90 69 70 1 1 1 1 1 23 24 24 24 25 1 1 1 1 1 1 1 1 18 19 19 19 19 19 19 19 19 19
19 19 19 19 19 20 1 1 1 1 1 89 90 1 1 23 7 14 15 1 1 1 1 18 19 19 19 19 19 19 19 19 19 19 19 19 19 20 11 28 27 19 19 19 19 19 19 19 19 20 1 1 1 1 1 1 1 1 1 1 1 1 1 1 89 90 99 100 99 100 89 90 1 1 1 1 1 1 1 1 1 1 1 1 1 1 1 1 1 8 37 19 19 19 19 19 19 19 19 19
19 19 19 19 26 30 1 1 1 11 1 99 100 1 3 4 17 14 15 1 1 1 1 28 27 19 19 19 19 19 19 19 19 19 19 19 19 20 11 11 28 27 19 19 19 19 19 19 19 20 1 1 1 1 1 1 1 1 1 1 1 1 1 1 99 100 1 1 1 1 99 100 1 1 1 1 1 1 1 1 1 1 1 1 1 1 1 1 1 18 19 19 19 19 19 19 19 19 19 19
19 19 19 19 20 1 1 1 1 11 1 1 1 1 13 14 14 14 15 1 1 1 1 1 28 27 19 19 19 19 19 19 19 19 19 19 19 36 10 11 11 18 19 19 19 19 19 19 19 20 1 11 11 1 1 1 11 11 1 1 1 1 1 1 1 1 1 1 1 1 1 1 1 1 1 1 1 1 1 1 1 1 1 1 1 1 1 1 1 18 19 19 19 19 19 19 19 19 19 19
19 19 19 19 20 1 1 1 1 11 1 3 4 4 17 14 6 24 25 1 1 1 1 1 1 18 19 19 19 19 19 19 19 19 19 19 19 19 36 9 9 37 19 19 19 19 19 19 26 30 1 1 1 1 11 11 11 11 1 1 1 1 1 1 1 1 1 1 1 1 1 11 11 11 11 1 1 1 1 1 1 1 1 1 1 1 1 1 1 18 19 19 19 19 19 19 19 19 19 19
19 19 19 19 20 1 1 1 11 1 1 13 14 14 14 14 15 1 1 1 1 1 1 1 1 18 19 19 19 19 19 19 19 19 19 19 19 19 19 19 19 19 19 19 19 19 19 26 30 1 1 1 1 1 1 1 1 1 1 1 11 11 1 1 1 1 1 1 1 1 1 1 1 1 1 11 11 69 70 11 11 11 11 11 1 1 1 1 1 18 19 19 19 19 19 19 19 19 19 19
19 19 19 19 20 1 1 1 11 1 1 13 14 6 24 24 25 1 1 1 1 1 1 1 1 28 27 19 19 26 29 27 19 26 27 19 19 19 19 19 19 19 19 19 19 19 26 30 1 1 1 1 1 1 1 1 1 1 1 1 1 1 1 11 11 1 1 1 1 1 1 1 1 1 1 1 1 79 80 1 1 1 1 1 1 1 1 1 1 18 19 19 19 19 19 19 19 19 19 19
19 19 19 19 20 1 1 1 11 1 1 13 14 15 1 1 1 69 70 1 11 1 1 1 1 1 28 29 29 30 1 18 19 20 28 27 19 19 19 19 19 19 19 19 26 29 30 1 1 1 1 1 1 1 1 1 1 1 1 1 1 1 1 1 1 11 1 1 1 1 1 1 1 1 1 1 1 89 90 1 1 1 1 1 1 1 1 1 1 18 19 19 19 19 19 19 19 19 19 19
19 19 19 19 20 1 1 1 11 1 1 13 14 15 1 1 1 79 80 1 11 1 1 1 1 1 1 1 1 1 8 37 19 20 1 28 29 29 29 29 29 27 19 19 36 10 1 1 1 1 1 1 1 1 1 8 9 9 9 9 10 1 1 1 1 1 11 1 1 1 1 1 1 1 1 1 1 99 100 11 1 1 1 1 1 1 1 1 1 18 19 19 19 19 19 19 19 19 19 19
19 19 19 19 20 1 1 1 1 11 1 13 14 16 5 1 1 89 90 1 1 11 1 1 1 1 1 1 1 8 37 19 19 20 1 1 1 1 1 1 1 28 27 19 19 36 9 10 1 1 1 1 1 1 1 18 19 19 19 19 36 9 10 1 1 1 1 1 1 1 1 1 69 70 1 1 1 1 11 11 1 1 1 1 1 1 1 1 1 18 19 19 19 19 19 19 19 19 19 19
19 19 19 19 20 1 1 1 1 11 1 13 14 14 16 5 1 99 100 1 1 1 11 1 1 1 1 1 1 18 19 19 26 30 1 1 1 1 1 1 1 1 28 27 19 19 19 36 9 9 9 9 9 9 9 37 19 26 27 19 19 19 20 1 1 1 1 11 1 1 1 1 79 80 1 1 1 1 11 1 11 1 1 1 1 1 1 1 1 18 19 19 19 19 19 19 19 19 19 19
19 19 19 19 20 1 1 1 1 11 1 13 14 14 14 16 5 1 1 1 1 1 11 1 1 1 1 1 8 37 19 26 30 1 1 1 1 1 1 1 1 1 1 28 29 27 19 19 19 19 19 19 19 19 19 19 19 20 28 29 27 19 20 1 1 1 1 11 1 1 1 1 89 90 1 1 1 1 11 11 11 1 11 1 1 1 1 1 1 18 19 19 19 19 19 19 19 19 19 19
19 19 19 19 20 1 1 1 1 11 1 23 7 14 14 14 16 5 1 1 1 1 11 11 1 1 1 1 18 19 19 20 1 1 1 1 1 11 1 1 1 1 1 1 1 28 29 29 27 19 19 19 26 29 27 19 19 20 1 1 18 19 20 1 1 1 1 1 11 1 1 1 99 100 1 1 1 1 1 1 1 1 11 1 1 1 1 1 1 18 19 19 19 19 19 19 19 19 19 19
19 19 19 19 20 1 1 1 1 11 1 1 23 7 14 14 14 16 5 1 1 1 1 11 1 1 1 1 28 29 29 30 1 1 1 1 11 1 1 1 1 1 1 1 1 1 1 1 28 29 29 29 30 1 28 29 29 30 1 1 18 19 36 10 1 1 1 1 1 11 1 1 1 1 1 1 1 1 1 1 1 1 11 11 1 1 1 1 8 37 19 19 19 19 19 19 19 19 19 19
19 19 19 19 20 1 1 1 1 11 1 1 1 23 7 14 14 14 15 1 1 1 1 1 1 1 1 1 1 1 1 1 1 1 1 11 11 1 1 1 1 1 1 1 1 1 1 1 1 1 1 1 1 1 1 1 1 1 1 1 18 19 19 36 10 1 1 1 1 1 11 1 1 1 1 1 1 1 1 1 1 1 1 11 1 1 1 1 18 19 19 19 19 19 19 19 19 19 19 19
19 19 19 19 20 1 1 1 1 11 1 1 1 1 23 7 6 24 25 1 1 1 1 1 1 1 1 1 1 1 1 1 1 1 1 11 1 1 1 11 11 1 1 1 1 1 1 1 1 1 1 1 1 1 1 1 1 1 1 1 28 27 19 19 36 10 1 1 1 1 1 11 1 1 1 1 1 1 1 1 1 1 11 1 1 1 1 1 18 19 19 19 19 19 19 19 19 19 19 19
19 19 19 19 20 1 1 1 1 11 1 1 69 70 3 17 16 5 1 1 1 1 1 1 1 1 1 1 1 1 1 1 1 1 11 1 1 1 1 1 11 1 1 1 1 1 1 1 1 1 1 1 1 1 1 1 1 11 1 1 1 28 27 19 19 36 10 1 1 1 1 1 1 1 1 1 1 1 1 1 1 11 11 1 1 1 1 1 18 19 19 19 19 19 19 19 19 19 19 19
19 19 19 19 20 1 1 1 1 1 11 1 79 80 13 14 14 15 1 1 1 1 1 1 1 1 1 1 1 1 1 1 1 11 1 1 1 1 1 1 1 1 1 1 1 1 1 1 1 1 1 1 1 1 1 1 1 11 11 1 1 1 28 27 19 19 36 10 1 1 1 1 1 1 1 1 1 1 1 1 11 11 1 1 1 1 1 8 37 19 19 19 19 19 19 19 19 19 19 19
19 19 19 19 20 1 1 1 1 1 11 1 89 90 13 14 6 25 1 1 1 1 1 1 1 1 1 1 1 1 1 1 1 1 1 1 1 1 1 1 1 1 11 11 38 38 38 34 35 38 1 1 1 1 1 1 1 1 11 1 1 1 1 28 27 19 19 36 10 1 1 1 1 1 1 1 1 11 11 1 1 1 1 1 1 1 1 18 19 19 19 19 19 19 19 19 19 19 19 19
19 19 19 19 20 1 1 1 1 11 11 1 99 100 13 14 15 1 38 38 38 38 38 38 34 35 38 1 1 1 1 11 11 1 1 1 1 1 1 1 1 69 70 11 39 39 39 44 54 39 1 1 1 1 1 1 1 1 1 11 1 1 1 1 28 27 19 19 36 10 1 1 1 1 1 1 1 1 11 11 1 1 1 1 1 1 1 18 19 19 19 19 19 19 19 19 19 19 19 19
19 19 19 19 20 1 1 1 1 11 1 1 1 3 17 14 15 1 39 39 39 39 39 39 44 54 39 1 1 1 1 11 1 1 1 1 1 1 1 1 1 89 90 11 39 39 39 39 39 39 1 1 1 1 1 1 1 1 1 1 11 1 1 1 1 28 27 19 19 36 10 1 1 1 1 1 1 1 1 1 1 1 11 11 11 1 1 28 29 29 27 19 19 19 19 19 19 19 19 19
19 19 19 26 30 1 1 1 1 1 1 1 1 13 14 6 25 1 39 39 39 39 39 39 39 39 39 1 1 1 1 11 1 1 1 1 1 1 1 1 1 99 100 11 45 48 47 49 46 50 1 1 1 1 1 1 1 1 1 1 1 11 1 1 1 1 28 27 19 19 36 9 9 10 1 1 1 1 1 1 1 1 1 1 11 11 1 1 1 1 28 27 19 19 19 19 19 19 19 19
19 19 19 20 1 1 1 1 1 1 1 1 3 17 14 15 1 1 45 46 47 49 48 47 49 46 50 1 1 1 1 11 1 1 1 1 1 1 1 1 1 3 4 5 55 58 57 59 56 60 11 11 11 1 1 1 1 1 1 1 1 1 11 1 1 1 1 28 27 19 19 19 19 36 9 9 10 1 1 1 1 1 1 1 1 11 11 69 70 1 8 37 19 19 19 19 19 19 19 19
19 19 19 20 1 1 1 1 1 1 1 1 13 14 6 25 1 1 55 56 57 59 58 57 59 56 60 1 1 1 1 11 1 1 1 1 1 1 1 3 4 17 14 16 17 14 15 1 69 70 1 1 1 11 11 11 11 1 1 1 1 1 11 1 1 1 1 1 28 29 29 27 19 19 19 19 20 1 1 1 1 11 1 1 1 1 1 89 90 1 18 19 19 19 19 19 19 19 19 19
19 19 19 36 10 1 1 1 1 1 1 1 13 14 15 1 1 1 1 1 1 13 14 15 1 1 1 1 1 1 1 11 69 70 69 70 3 4 4 17 14 14 14 14 14 14 15 1 89 90 1 1 1 1 1 1 1 11 11 1 1 1 1 11 1 1 1 1 1 1 1 28 29 29 27 19 20 1 1 1 1 11 1 1 1 1 1 99 100 1 18 19 19 19 19 19 19 19 19 19
19 19 19 19 20 1 1 1 11 1 1 1 13 14 15 1 1 1 1 3 4 17 14 16 4 4 4 4 4 4 4 5 89 90 89 90 13 14 14 14 6 24 24 24 7 6 25 1 99 100 1 3 4 4 4 5 69 70 1 11 1 1 1 1 11 1 1 1 1 1 1 1 1 1 18 19 20 1 1 1 11 1 1 1 1 8 9 9 9 9 37 19 19 19 19 19 19 19 19 19
19 19 19 19 20 1 1 11 1 1 1 1 13 14 16 4 5 1 3 17 6 7 14 6 24 7 14 14 14 14 14 15 99 100 99 100 13 14 14 6 25 1 1 1 13 16 4 4 4 4 4 17 6 7 6 25 89 90 1 1 11 1 1 1 1 11 11 11 1 1 1 1 1 1 18 19 20 1 1 1 11 1 1 1 8 37 19 19 19 19 19 19 19 19 19 19 19 19 19 19
19 19 19 19 20 1 1 11 1 1 1 1 13 14 14 14 16 4 17 6 25 13 14 15 1 23 24 24 24 24 7 16 4 4 4 4 17 14 14 15 1 1 1 1 23 24 24 24 24 24 24 24 25 13 15 1 99 100 1 1 11 1 1 1 1 1 1 11 1 1 1 1 1 1 18 19 20 1 1 1 11 1 1 8 37 19 19 19 19 19 19 19 19 19 19 19 19 19 19 19
19 19 19 19 20 1 11 11 1 1 1 1 23 24 7 14 14 14 6 25 1 23 7 15 1 1 1 1 1 1 23 24 24 24 7 14 14 14 14 15 1 1 1 1 1 1 11 1 1 1 1 11 1 13 15 69 70 1 1 1 1 11 1 1 1 1 1 1 1 1 1 1 1 1 18 19 20 1 1 1 11 69 70 18 19 19 19 19 19 19 19 19 19 19 19 19 19 19 19 19
19 19 19 19 20 1 11 1 69 70 1 1 1 1 23 24 24 24 25 1 1 1 13 15 1 1 1 1 1 1 1 1 1 1 23 24 24 7 6 25 1 1 1 1 1 1 11 11 11 69 70 11 11 13 15 89 90 1 1 1 1 11 11 1 1 1 1 1 1 1 11 11 1 1 18 19 36 10 1 1 11 89 90 18 19 26 29 29 29 29 27 19 19 19 19 19 19 19 19 19
19 19 19 26 30 1 69 70 79 80 1 1 1 1 69 70 1 1 1 1 1 1 13 15 1 1 1 1 1 11 1 1 1 1 1 1 1 13 15 69 70 1 1 11 11 1 1 1 1 89 90 1 1 13 15 99 100 11 11 11 11 11 11 11 11 11 11 11 11 11 1 11 1 1 18 19 19 36 10 1 1 99 100 18 19 20 1 1 1 1 18 19 19 19 19 19 19 19 19 19
19 19 19 20 1 1 79 80 89 90 1 1 1 1 89 90 1 1 1 1 1 1 13 15 1 1 1 1 1 11 1 1 1 1 1 1 1 13 15 89 90 11 11 11 11 11 11 11 11 99 100 1 1 13 15 1 1 1 1 1 1 1 1 1 11 1 1 1 1 1 1 1 1 1 28 27 19 19 36 9 10 1 8 37 19 20 1 1 1 1 18 19 19 19 19 19 19 19 19 19
19 19 19 20 1 1 89 90 99 100 11 11 1 1 99 100 1 1 1 1 1 3 17 15 1 1 1 1 1 1 11 1 1 1 1 1 1 13 15 99 100 1 1 38 34 35 38 38 38 11 11 11 3 17 16 5 1 1 1 11 11 11 11 11 11 1 1 1 1 1 1 1 1 1 1 28 27 19 19 19 36 9 37 19 19 20 1 1 1 1 18 19 19 19 19 19 19 19 19 19
19 19 19 20 1 1 99 100 1 1 1 11 1 1 1 1 1 1 1 1 1 13 14 15 1 1 1 1 1 1 11 1 1 1 1 1 1 13 15 1 1 1 1 39 44 54 39 39 39 1 1 1 13 14 14 15 1 1 1 1 1 1 1 1 1 1 1 1 1 1 1 1 1 1 1 1 28 29 27 19 19 19 19 19 26 30 1 11 1 1 18 19 19 19 19 19 19 19 19 19
19 19 19 20 1 1 1 1 1 1 1 1 1 1 1 1 1 1 1 1 1 23 7 15 1 8 9 10 1 1 1 1 1 1 1 1 1 13 16 4 4 5 1 39 39 39 39 39 39 1 1 1 13 14 14 15 1 1 1 1 1 1 11 11 11 1 1 11 11 1 1 1 1 1 1 1 1 1 28 29 29 29 29 29 30 1 1 1 11 1 18 19 19 19 19 19 19 19 19 19
19 19 19 20 1 1 1 1 1 1 1 1 1 1 1 8 9 9 9 9 9 10 23 25 8 37 19 36 10 1 1 1 1 1 1 1 1 23 24 24 7 15 1 45 48 47 49 46 50 1 1 3 17 14 6 25 1 1 1 1 1 1 1 1 1 1 1 1 1 1 1 1 1 1 1 1 1 1 1 1 1 1 1 1 1 1 1 11 11 1 18 19 19 19 19 19 19 19 19 19
19 19 19 20 1 1 1 1 1 1 1 1 1 1 1 18 19 19 19 19 19 20 1 1 18 19 19 19 20 1 1 1 1 1 1 1 1 1 1 11 13 15 1 55 58 57 59 56 60 1 3 17 14 6 25 1 1 1 1 1 1 1 1 1 1 1 1 1 1 1 11 11 11 1 1 1 1 1 1 1 1 1 1 1 1 1 1 11 1 1 18 19 19 19 19 19 19 19 19 19
19 19 19 36 9 9 9 9 9 9 9 10 1 8 9 37 19 19 19 19 19 36 10 1 18 19 19 19 36 9 9 9 9 9 10 1 1 1 1 11 13 16 4 17 14 15 1 1 1 1 13 14 6 25 1 1 1 1 1 1 1 1 1 1 1 1 1 11 11 11 1 1 1 1 1 1 1 1 1 1 1 1 1 1 1 1 1 1 1 1 28 27 19 19 19 19 19 19 19 19
19 19 19 19 19 19 19 19 19 19 19 36 9 37 19 19 19 19 19 19 19 19 36 9 37 19 19 19 19 19 19 19 19 19 36 10 1 1 1 1 23 24 24 7 14 15 1 1 1 1 13 14 15 1 1 1 1 1 1 1 1 1 11 11 11 11 11 1 1 1 1 1 1 1 1 1 1 1 1 1 1 8 9 9 9 9 9 9 9 9 9 37 19 19 19 19 19 19 19 19
19 19 19 19 19 19 19 19 19 19 19 19 19 19 19 19 19 19 19 19 19 19 19 19 19 19 19 19 19 19 19 19 19 19 19 36 10 1 1 1 1 1 1 13 14 16 4 4 4 4 17 6 25 1 1 8 9 9 9 9 9 10 1 1 1 1 1 1 1 1 1 1 1 1 1 1 1 1 1 8 9 37 19 19 19 19 19 19 19 19 19 19 19 19 19 19 19 19 19 19
19 19 19 19 19 19 19 19 19 19 19 19 19 19 19 19 19 19 19 19 19 19 19 19 19 19 19 19 19 19 19 19 19 19 19 19 36 9 9 10 1 1 1 23 24 24 24 24 24 24 24 25 8 9 9 37 19 19 19 19 19 36 9 9 9 10 1 1 1 1 1 1 1 1 1 8 9 9 9 37 19 19 19 19 19 19 19 19 19 19 19 19 19 19 19 19 19 19 19 19
19 19 19 19 19 19 19 19 19 19 19 19 19 19 19 19 19 19 19 19 19 19 19 19 19 19 19 19 19 19 19 19 19 19 19 19 19 19 19 36 9 10 1 1 1 1 1 1 1 8 9 9 37 19 19 19 19 19 19 19 19 19 19 19 19 36 9 9 9 9 9 9 9 9 9 37 19 19 19 19 19 19 19 19 19 19 19 19 19 19 19 19 19 19 19 19 19 19 19 19
19 19 19 19 19 19 19 19 19 19 19 19 19 19 19 19 19 19 19 19 19 19 19 19 19 19 19 19 19 19 19 19 19 19 19 19 19 19 19 19 19 36 9 10 1 1 1 8 9 37 19 19 19 19 19 19 19 19 19 19 19 19 19 19 19 19 19 19 19 19 19 19 19 19 19 19 19 19 19 19 19 19 19 19 19 19 19 19 19 19 19 19 19 19 19 19 19 19 19 19
19 19 19 19 19 19 19 19 19 19 19 19 19 19 19 19 19 19 19 19 19 19 19 19 19 19 19 19 19 19 19 19 19 19 19 19 19 19 19 19 19 19 19 36 9 9 9 37 19 19 19 19 19 19 19 19 19 19 19 19 19 19 19 19 19 19 19 19 19 19 19 19 19 19 19 19 19 19 19 19 19 19 19 19 19 19 19 19 19 19 19 19 19 19 19 19 19 19 19 19
19 19 19 19 19 19 19 19 19 19 19 19 19 19 19 19 19 19 19 19 19 19 19 19 19 19 19 19 19 19 19 19 19 19 19 19 19 19 19 19 19 19 19 19 19 19 19 19 19 19 19 19 19 19 19 19 19 19 19 19 19 19 19 19 19 19 19 19 19 19 19 19 19 19 19 19 19 19 19 19 19 19 19 19 19 19 19 19 19 19 19 19 19 19 19 19 19 19 19 19
19 19 19 19 19 19 19 19 19 19 19 19 19 19 19 19 19 19 19 19 19 19 19 19 19 19 19 19 19 19 19 19 19 19 19 19 19 19 19 19 19 19 19 19 19 19 19 19 19 19 19 19 19 19 19 19 19 19 19 19 19 19 19 19 19 19 19 19 19 19 19 19 19 19 19 19 19 19 19 19 19 19 19 19 19 19 19 19 19 19 19 19 19 19 19 19 19 19 19 19
1 2 0 map2
1 3 0 map3
2 22 8 2
2 28 10 2
2 37 10 1
2 50 10 2
2 41 12 2
2 55 13 1
2 13 14 2
2 68 14 2
2 78 15 1
2 17 17 1
2 21 20 2
2 52 20 2
2 58 20 2
2 81 20 2
2 54 21 2
2 55 21 2
2 56 21 2
2 40 22 2
2 53 22 2
2 57 22 2
2 89 22 1
2 53 23 2
2 55 23 3
2 57 23 2
2 53 24 2
2 57 24 2
2 54 25 2
2 55 25 2
2 56 25 2
2 52 26 2
2 58 26 2
2 84 27 2
2 25 28 2
2 73 30 2
2 86 31 1
2 89 32 2
2 22 35 2
2 25 35 1
2 40 35 2
2 81 35 2
2 14 38 2
2 88 39 2
2 94 39 2
2 6 40 1
2 52 41 2
2 65 41 2
2 22 43 2
2 16 44 2
2 81 44 2
2 86 44 2
2 93 44 2
2 90 46 1
2 74 47 2
2 14 49 2
2 45 49 1
2 65 49 2
2 86 52 2
2 54 53 2
2 76 54 2
2 39 56 1
2 51 58 2
2 81 59 2
2 66 61 1
2 14 61 1
2 66 61 1
2 83 62 1
2 23 63 2
2 67 64 2
2 58 66 1
2 79 68 2
2 29 73 2
2 53 74 2
2 81 75 1
2 79 79 2
2 61 83 2
2 11 89 1
2 54 87 1
2 71 91 1
2 82 92 1
2 87 83 1
2 89 83 1
2 85 84 1
2 88 84 1
2 87 85 1
2 89 85 1
2 90 86 1
2 86 87 1
2 88 87 1
2 84 88 1
2 87 88 1
2 89 88 1
2 86 89 1
2 88 89 1
2 85 90 1
2 87 90 1
2 89 90 1
2 86 91 1
2 88 91 1
2 90 91 1
2 87 92 1