10 10 overworld map1 2 2
1 1 1 1 1 1 1 1 1 1
1 3 4 4 5 1 1 1 1 1
1 13 14 14 15 1 1 1 1 1
1 13 14 14 15 1 1 1 1 1
1 23 24 24 25 1 1 1 1 1
1 1 1 1 1 1 1 1 1 1
1 1 1 1 1 1 1 1 1 1
1 1 1 1 1 1 1 1 1 1
1 1 1 1 1 1 1 1 1 1
1 1 1 1 1 1 1 1 1 1