10 7 overworld map1 5 10
12 12 12 12 12 12 12 12 12 12
12 1 1 1 1 1 1 1 1 12
12 1 1 1 1 1 1 1 1 12
1 1 1 1 1 1 1 1 1 1
12 1 1 1 1 1 1 1 1 12
12 1 1 1 1 1 1 1 1 12
12 12 12 12 12 12 12 12 12 12
3 9 3 map1 34 24